111111111111111111111111111111111
100000001000000010000000100000001
101101101011011010110110101101101
101101101011011010110110101101101
1000000000000000100000#0000000001
101101011101011010110101110101101
100001001001000010000100100100001
111101101011011111110110101101111
000101000001010000010100000101000
111101011101011111110101110101111
000000011100000000000001110000000
111101000001011111110100000101111
0001#1011101010000010101110101000
111101011101011111110101110101111
100000001000000010000000100000001
101101101011011010110110101101101
1001000000000100100100#0000001001
110101011101010111010101110101011
100001001001000010000100100100001
101111101011111010111110101111101
1000000#0000000010000000000000001
111111111111111111111111111111111
