1
1---------111111111111111111111111111
1000000010000000110000000100000001011
1011011010110110110110110101101101011
1011011010110110110110110101101101001
1000B000V000B00011000B000V000B0001011
1011010111010110110110101110101101001
1000010010010000000000100100100000011
1111011010110111111110110101101101011
===00100#0010100000010100100101000===
11110101#1010111101000101101111111011
11110101#1010111101010001100000000001
00000001#1000000001000101111011101011
1111010111010111101101101100011101001
1111010000010111100001101111010000011
===0010111010100001101101110010110===
1111010111010111111100000011000100011
1000B0001000B000100001011001101111011
1011011010110110110111011100001111011
10010000P0000100000101011101100000011
1111111111111111111111111111111111111
