1
11111111111111111
10000000100000001
10110110101101101
10110110101101101
10000000000000001
10110101110101101
10000100100100001
11110110101101111
00010100#00101000
11110101#10101111
11110101#10101111
00000001#10000000
11110101110101111
11110100000101111
00010101110101000
11110101110101111
10000000100000001
10110110101101101
10010000P00001001
11010101110101011
10000100100100001
10111110101111101
10000000000000001
11111111111111111
