1
1---------111111111
1B000100000001B0001
1011010111110101101
1010000000000000101
1010110111111010101
10100101####+000101
1000110111111010001
101000000V000000101
1010110111110110101
101000000P000000101
1011010111110101101
1000B100000001000B1
1111111111111111111
