1
1---------11111111111
000000100000001000000
111110101111101011111
1B00000000100000000B1
101111101010101111101
101000001000100000101
101011101111101110101
100000100000001000001
111110101111101011111
100000101###+01000001
101110001111100011101
1000101000V0001010001
111010110111011010111
==10000001110000001==
111011110111011110111
0000001000P0001000000
111010101111101010111
1B00100000100000100B1
101110111010111011101
100000000000000000001
111111111111111111111
