1
1---------1111111
10000000100000001
1B1101101011011B1
10000000000000001
10110101110101101
10000100100100001
11110110101101111
===1010+#+0101===
11110101#10101111
11110101#10101111
00000001#10000000
11110101110101111
11110100V00101111
===10101110101===
11110101110101111
10000000100000001
10110110101101101
1B010000P000010B1
11000101110100011
11111111111111111
