1
111111111111111111111
000000100000001000000
111110101111101011111
100000000010000000001
101111101010101111101
101000001000100000101
101011101111101110101
100000100000001000001
1111101011#1101011111
100000101###101000001
101110001111100011101
1000101000P0001010001
111010110111011010111
==10000001110000001==
111011110111011110111
000000100000001000000
111010101111101010111
100010000010000010001
101110111010111011101
100000000000000000001
111111111111111111111
