1
I1---------11111111111L
I000000100000001000000L
I111110101111101011111L
I100000000010000000001L
I101111101010101111101L
I101000001000100000101L
I101011101111101110101L
I100000100000001000001L
I1111101011#1101011111L
I100000101###101000001L
I101110001111100011101L
I1000101000P0001010001L
I111010110111011010111L
I==10000001110000001==L
I111011110111011110111L
I000000100000001000000L
I111010101111101010111L
I100010000010000010001L
I101110111010111011101L
I100000000000000000001L
I111111111111111111111L
