1
1111111111111111111111111111111111111111
1000000010000000100000001000000010000011
1011011010110110101101101011011010101011
1011011010110110101101101011011010101011
1000000000000000100000000000000010101011
1011010111010110101101011101011010101011
1000010010010000100001001001000010101011
1111011010110100000101101011011110111011
0001010000010111111101000001010000010011
11110101110101#00#10010111010101110101111
0000000111000100000001011100000000010000
11110100000101#00#10010000010101110101111
0001010111010111111101011101010000010011
1111010111010100000101011101011110111011
1000000010000000100000001000000010101011
1011011010110110101101101011011010101011
10010000P0000100100100000000010010101011
1101010111010101110101011101010110101011
1000010010010000100001001001000010101011
1011111010111110101111101011111010101011
1000000000000000100000000000000010000011
1111111111111111111111111111111111111111
