1
1---------111111111
1B00010000000100001
1011010111110101101
101000000V000000101
1010110111111010101
10000101####+000001
1010110111111010101
101000000P000000101
1011010111110101101
10000100000001000B1
1111111111111111111
