1
1---------111111111
1000010000000100001
1011010111110101101
1010000000000000101
101011011#110110101
10100001###10000101
1000110111110110001
101000000P000000101
1010110111110110101
1010000000000000101
1011010111110101101
1000010000000100001
1111111111111111111
