11111111111111111
10000000100000001
10110110101101101
10110110101101101
10000000000000001
10110101110101101
10000100100100001
11110110101101111
00010100000101000
11110101110101111
00000001110000000
11110100000101111
00010101110101000
11110101110101111
10000000100000001
10110110101101101
10010000000001001
11010101110101011
10000100100100001
10111110101111101
10000000000000001
11111111111111111
