1
I1---------111111111L
I1000010000000100001L
I1011010111110101101L
I1010000000000000101L
I101011011#110110101L
I10100001###10000101L
I1000110111110110001L
I101000000P000000101L
I1010110111110110101L
I1010000000000000101L
I1011010111110101101L
I1000010000000100001L
I1111111111111111111L
