1
I1---------1111111L
I10000000100000001L
I1B1101101011011B1L
I10000000000000001L
I10110101110101101L
I10000100100100001L
I11110110101101111L
I===10100#00101===L
I11110101#10101111L
I11110101#10101111L
I00000001#10000000L
I11110101110101111L
I11110100V00101111L
I===10101110101===L
I11110101110101111L
I10000000100000001L
I10110110101101101L
I1B010000P000010B1L
I11000101110100011L
I11111111111111111L
